{
  "gridSize": {
    "rows": 5,
    "columns": 10
  },
  "blockPositions": [
    {"type": "standard", "positions": [
      {"x": 200, "y": 100},
      {"x": 240, "y": 100},
      {"x": 280, "y": 100},
      {"x": 320, "y": 100},
      {"x": 360, "y": 100},
      {"x": 400, "y": 100},
      {"x": 440, "y": 100},
      {"x": 480, "y": 100},
      {"x": 520, "y": 100},
      {"x": 560, "y": 100},
      {"x": 200, "y": 140},
      {"x": 240, "y": 140},
      {"x": 280, "y": 140},
      {"x": 320, "y": 140},
      {"x": 360, "y": 140},
      {"x": 400, "y": 140},
      {"x": 440, "y": 140},
      {"x": 480, "y": 140},
      {"x": 520, "y": 140},
      {"x": 560, "y": 140},
      {"x": 200, "y": 180},
      {"x": 240, "y": 180},
      {"x": 280, "y": 180},
      {"x": 320, "y": 180},
      {"x": 360, "y": 180},
      {"x": 400, "y": 180},
      {"x": 440, "y": 180},
      {"x": 480, "y": 180},
      {"x": 520, "y": 180},
      {"x": 560, "y": 180},
      {"x": 200, "y": 220},
      {"x": 240, "y": 220},
      {"x": 280, "y": 220},
      {"x": 320, "y": 220},
      {"x": 360, "y": 220},
      {"x": 400, "y": 220},
      {"x": 440, "y": 220},
      {"x": 480, "y": 220},
      {"x": 520, "y": 220},
      {"x": 560, "y": 220},
      {"x": 200, "y": 260},
      {"x": 240, "y": 260},
      {"x": 280, "y": 260},
      {"x": 320, "y": 260},
      {"x": 360, "y": 260},
      {"x": 400, "y": 260},
      {"x": 440, "y": 260},
      {"x": 480, "y": 260},
      {"x": 520, "y": 260},
      {"x": 560, "y": 260}
    ]}
  ]
} 