{
  "gridSize": {
    "rows": 11,
    "columns": 10
  },
  "blockPositions": [
    {"type": "standard", "positions": [
      {"x": 200, "y": 100},
      {"x": 240, "y": 100},
      {"x": 280, "y": 100},
      {"x": 320, "y": 100},
      {"x": 360, "y": 100},
      {"x": 400, "y": 100},
      {"x": 440, "y": 100},
      {"x": 480, "y": 100},
      {"x": 520, "y": 100},
      {"x": 560, "y": 100},
      {"x": 200, "y": 140},
      {"x": 280, "y": 140},
      {"x": 360, "y": 140},
      {"x": 440, "y": 140},
      {"x": 520, "y": 140},
      {"x": 200, "y": 180},
      {"x": 240, "y": 180},
      {"x": 280, "y": 180},
      {"x": 320, "y": 180},
      {"x": 360, "y": 180},
      {"x": 400, "y": 180},
      {"x": 440, "y": 180},
      {"x": 480, "y": 180},
      {"x": 520, "y": 180},
      {"x": 560, "y": 180},
      {"x": 200, "y": 220},
      {"x": 280, "y": 220},
      {"x": 360, "y": 220},
      {"x": 440, "y": 220},
      {"x": 520, "y": 220},
      {"x": 200, "y": 420},
      {"x": 240, "y": 420},
      {"x": 280, "y": 420},
      {"x": 320, "y": 420},
      {"x": 360, "y": 420},
      {"x": 400, "y": 420},
      {"x": 440, "y": 420},
      {"x": 480, "y": 420},
      {"x": 520, "y": 420},
      {"x": 560, "y": 420},
      {"x": 200, "y": 460},
      {"x": 280, "y": 460},
      {"x": 360, "y": 460},
      {"x": 440, "y": 460},
      {"x": 520, "y": 460},
      {"x": 200, "y": 500},
      {"x": 240, "y": 500},
      {"x": 280, "y": 500},
      {"x": 320, "y": 500},
      {"x": 360, "y": 500}
    ]},
    {"type": "strong", "positions": [
      {"x": 240, "y": 140},
      {"x": 320, "y": 140},
      {"x": 400, "y": 140},
      {"x": 480, "y": 140},
      {"x": 560, "y": 140},
      {"x": 240, "y": 220},
      {"x": 320, "y": 220},
      {"x": 400, "y": 220},
      {"x": 480, "y": 220},
      {"x": 560, "y": 220},
      {"x": 200, "y": 260},
      {"x": 240, "y": 260},
      {"x": 280, "y": 260},
      {"x": 320, "y": 260},
      {"x": 360, "y": 260},
      {"x": 400, "y": 260},
      {"x": 440, "y": 260},
      {"x": 480, "y": 260},
      {"x": 520, "y": 260},
      {"x": 560, "y": 260},
      {"x": 200, "y": 300},
      {"x": 280, "y": 300},
      {"x": 360, "y": 300},
      {"x": 440, "y": 300},
      {"x": 520, "y": 300},
      {"x": 200, "y": 340},
      {"x": 240, "y": 340},
      {"x": 280, "y": 340},
      {"x": 320, "y": 340},
      {"x": 360, "y": 340},
      {"x": 400, "y": 340},
      {"x": 440, "y": 340},
      {"x": 480, "y": 340},
      {"x": 520, "y": 340},
      {"x": 560, "y": 340},
      {"x": 240, "y": 460},
      {"x": 320, "y": 460},
      {"x": 400, "y": 460},
      {"x": 480, "y": 460},
      {"x": 560, "y": 460}
    ]},
    {"type": "dynamite", "positions": [
      {"x": 240, "y": 300},
      {"x": 320, "y": 300},
      {"x": 400, "y": 300},
      {"x": 480, "y": 300},
      {"x": 560, "y": 300},
      {"x": 200, "y": 380},
      {"x": 560, "y": 380},
      {"x": 400, "y": 500},
      {"x": 440, "y": 500},
      {"x": 480, "y": 500},
      {"x": 520, "y": 500},
      {"x": 560, "y": 500}
    ]},
    {"type": "eternal", "positions": [
      {"x": 240, "y": 380},
      {"x": 280, "y": 380},
      {"x": 320, "y": 380},
      {"x": 360, "y": 380},
      {"x": 400, "y": 380},
      {"x": 440, "y": 380},
      {"x": 480, "y": 380},
      {"x": 520, "y": 380}
    ]}
  ]
} 